2 13 31
###############################
#p  s** **    *   2           #
# # # #*# # # # # # # # # # # #
#*     ** * *  *   * **   *   #
# # # # # #*# # # # # # #*# # #
#*   *s*    *** * x **        #
# # # # # # # # # # # # # #*# #
#    *     *        *    **   #
# #*# # #*#*#*#*# # #1# # #*# #
#     2   *   **    *   *     #
#*# # # # # # # # # # #*# # #*#
# *    * **    ** ***     1   #
###############################